0 0 0 0 0 0 6 6 6 6 6 0 0 0 3 3
0 0 5 0 0 0 0 0 0 0 0 0 0 0 3 3
7 0 5 0 0 1 0 0 0 0 0 0 0 0 3 3
0 0 5 0 0 1 0 1 0 0 1 0 1 0 0 3
0 0 5 5 5 5 5 5 5 5 5 5 5 5 5 3
0 0 5 0 0 0 0 0 0 0 7 0 0 0 0 3
1 0 5 0 1 0 1 0 0 0 7 0 0 0 0 3
0 1 5 0 0 0 1 0 0 7 7 7 7 0 0 3
1 0 5 0 0 1 0 4 4 4 4 4 4 0 0 3
0 1 5 0 0 0 0 4 4 4 4 4 4 4 4 3
0 0 5 0 0 0 0 4 4 4 4 4 4 4 4 3
0 0 5 0 6 6 6 6 4 4 4 4 4 4 4 3